2222222222222222
2111111111111112
2111111111111112
2111111111111112
2111111111111112
2111111111111112
2111111111111112
2111111111111112
2111111111111112
2111111111111113
2111111111111113
2111111111111112
2111111111111112
2222222222222222