                          11111111111111111111111111111111
                          10000000000000000000000000000001
                          10000000000000000000000000000001
1111111111111111          10000000000000000000000000000001                     111111111111111111111
1000000000000001          10000000000000000000000000000001                     100000000000000000001
1000000000000001          10000000000000000000000000000001                     100000000000000000001
1000000000000001          10000000000000000000000000000001                     100000000000000000001
1000000000000001          10000000000000000000000000000001                     100000000000000000001
1000000000000001          10000000000000000000000000000001                     100000000000000000001
1000000000000001111111111111110011111111111111111110011111111111111111111111111100000000000000000001
1000000000000001000000000000000000000000000000000000000000000000000000000000000000000000000000000001
1000000000000000000000000000000000000000000000000000000000000000000000000000000000000000000000000001
1000000000000000000000000000000000000000000000000000000000000000000000000000000000000000000000000001
1000000000000001000000000000000000000000000000000000000000000000000000000000000000000000000000000001
1000000000000001111111111111111111111111111110011111111111111111111111111111111100000000000000000001
1000000000000001                           100001                              100000000000000000001
1111111111111111                           100001                              100000000000000000001
                                           100001                              100000000000000000001
                                           100001                              100000000000000000001
                                           100001                              111111111111111111111
                                           100001
                                           100001
                                           100001
                                    11111111000011111111
                                    10000000000000000001
                                    10000000000000000001
                                    10000000000000000001
                                    10000000000000000001
                                    10000000000000000001
                                    10000000000000000001
                                    10000000000000000001
                                    10000000000000000001
                                    11111111111111111111